40 25
S S S M M S S S S M M 1 M M S S S S S M M 1 M M S S S S S S M M 1 M M S S S S S
S 5 M M M M M S M M M M M M M M M M M M M M M M M M M M M M M M M M M M M M 3 S
S 5 M M M M M S M M M M M M M M M M M M M M M M M S S S M M M M M M M M M S 2 S
S S S S S S M S M M M M M S M M M M M M M M M M M M S M M M M M S S M M M S 1 S
M M M M M M M S M M M S S S S M M M M M M M M M S 2 S M M M M S S S S M M S M S
S 1 S M M M M S M M S S E E S S M M M M M M M M M M S M M M M 2 S S 2 M M S M S
S 2 S M M S S S M M M S E E S M M M M S M S M M S 2 S M M M M S S S S M M S M S
S 3 S M M S 2 S M M S S E E S S M M M S 8 S M M M M S M S M M M S S M M M S 1 S
S 2 S M M S M S M M M S 10 E S M M M M S S S M M S 2 S M S M M M M M M M M S 2 S
M 1 S M M M M S M M S S S S S S M M M M M M M M M M S 5 S M M M M M M M M M 3 S
S M S M M M M S M M M M S M M M M M M M M M M M M M S S S M M S S S S S S S S S
S M S M M M M S S M M M M M M M M M M M M M M M M S M M M M M M M M M M M M - 3
S M M M M M M S M M M M M M M M M M M M M M M M M M M M M M M M M M M M M M - 3
S M M M M M S S 5 M S M M M M M M M M M M S S S M M M M M M M M M M M M M M - 3
S S S M M S S S S S S S M M S S S M M S S S S S S S S M M M M M M M M M M M - 3
S M M M M M M M M M M M M M M S M M M M M M M M M M S S S M M S S S S S S S S S
S M M M M M M M M M M M M M M S M M M M M M M M M M S M M M M M M M M M M M M S
S M M M M M M M M M M M M M S S M M M M M M M M M S S S M M M M M M M M M M M S
M M S S M M M M M S S S S S S S S S M M M S S S S S S S S S S S M M M M M S S S
M M 4 S M S M M M S 4 M M M 4 S 2 S M M M S 2 M M 2 S 2 M M 2 S M M M M M S 2 S
S M 3 S M M M M M S M M 4 M M S M S M S M S M M M M S M M M M S M M M S M S M S
S M 2 S M S M M M S 4 M M M 4 S M S M M M S 2 M M 2 S 2 M M 2 S M M M M M S M S
S M 1 S M M M M M S S S S S M S M S M M M S S S S M S M S S S S M M M M M S M S
S M M M M M M M M M M M M M M S M M M M M M M M M M S M M M M M M M M M M M M S
S S S S S M M M M S S S S S S S S S S M M M M S S S S S S S S M M M M S S S S S
