40 25
M M M M M S M M M M M M M M M M M M M 10 M M M M M M M M M M M M M M M M M S M 22
M M M M S S S M M M M M M M M M M M M S M M M M M M M M M M M M M M M M M M S E
M M M S E E E S M M M M M M M M M M S S S M M M M M M M M M M M M M M M M M 5 S
M M S S E 22 E S S M M M M M M M M S M 10 M S M M M M M M M M M M M M M S S S S S
M M M S E E E S M M M M M M M M S M M S M M S M M M M M M M M M M M S 3 M M 5 S
M M M M S S S M M M M M M M M S M M S S S M M S M M M M M M M M M M M M S S S S
M M M M M S M M M M M M M M S M M M M 5 M M M M S M M M M M M M M M M S M M 5 S
M M M M M M M M M M M M M S M M S S S S S S S M M S M M M M M M M M S 3 M S S S
M M M M M M M M M M M M S M M M M M M 5 M M M M M M S M M M M M M M S M M M 5 S
M M M M M M M M M M M S M M S S S S S S S S S S S M M S M M M M M M M M M S S S
M M M M M M M M M M S M M M M M M M M 5 M M M M M M M M S M M M M M M M S 3 M S
M M M M M M M M M S M M S S S S S S S S S S S S S S S M M S M M M M M M S M M S
M M M M M M M M S M M M M M M M M M M 5 M M M M M M M M M M S M M M M M M M M S
M M M M M M M S M M S S S S S S S S S S S S S S S S S S S M M S M M M M M M M S
M M M M M M S M M M M M M M M M M M M 5 M M M M M M M M M M M M S M M M M M M S
M M M M M S M M S S S S S S S S S S S S S S S S S S S S S S S M M S M M M M M S
M M M M S M M M M M M M M M M M M M M 5 M M M M M M M M M M M M M M S M M M M S
M M M S M M S S S S S S S S S S S S S S S S S S S S S S S S S S S M M S M M M S
M M S 5 M M M M M M M M M M M M M M M 5 M M M M M M M M M M M M M M M 5 S M M S
M S S S S S S S S S S S S S S S S S M M M S S S S S S S S S S S S S S S S S M M
M M M M M M M M M M M M M M M M M M M M M M M M M M M M M M M M M M M M M M M M
M M M M M M M M M M M M M M M M S M M M M M S M M M M M M M M M M M M M M M M M
M M M M M M M M M M M M M M M M S M M M M M S M M M M M M M M M M M M M M M M M
M M M M M M M M M M M M M M M M S M M M M M S M M M M M M M M M M M M M M M M M
10 M M M M M M M M M M M M M M M S - - M - - S M M M M M M M M M M M M M M M M 10
