40 25
S S S S S S S S S S S S S S S S S S S S S S S S S S S S S S S S S S S S S S S S
S M 3 M M M S M S M M M M M M S M 8 1 S M S S M M S M M M M S S M M 1 9 S S S S
S S M M S M M M M S S S S 1 M S M 4 M S S M 8 S S M S S S M M M S S M M M M M S
S S S S S S M M M M M S S M M M M M M S S M M M S S M M S M S S S M M M S M S S
S M S M M S M S M M 8 M M M S M S M M M M S M M M S 3 S M M M S M M M S S M S S
S M M 5 S M M - M S S M S S M S 7 S M S M M M M M S M - M S S M M S 1 M M M S S
S M M M M M S M M S S M S M M M M M M M S 1 S M M S M M M S S S S S S M M M M S
S S M M M M S M M M M S M S M M M S M M S S M S M M M M S M S S M M M M M M M S
S M M M S M S S S S S M S M M M M M M M S M M S S S S M 2 M S M S S M S M M M S
S M M S S S M M S 7 M M M S 3 S S S S S M M M M M M S M M M S S M M S M M S M S
S M M M M M M M M S M M M M S S S M M S M M M S M S S M S M 9 M M M S M M M M S
S M S M M S S M S S S M M S M M M S M M M M M S 9 M S S M S S M S S M S M S M S
S M M M M M S S M M M M M S M M M S M M M S S S 1 M 3 S M M M M S S M M M M S S
S M S S 8 M S M M M S M S S M 3 S S M M M M M S S M S M S S M M M M M S M M M S
S S M M M M M M S M M M 2 M S M M M M M M S M S M M M M M M M S S S M M M S M S
S S M S M M 4 S M S S S 1 S M M S S M M M M S 6 S S S M S M M M M M M S S S M S
S S M S S M M M S M S 8 8 S M M S M M M M S S M M M M S M M S S M M M S M M S S
S M M S S M M M S M S M S S M M M 2 M S M M S M M M S 7 M - S S S M M M M M M S
S M M M S S S S S M S M - M M M M S S M S S M M S M M S M S M S M M S M S M M S
S M M M S S S M M M S S M M M M M M S M S M S S M S M M S S M M M M M M S S S S
S M 1 M M S M S S M S M M S M M M M S M 5 M 4 M S M M S M S S M M M M M S 5 S S
S S M M M S 1 9 S M M M M M S M M M S S M S S M M M M S M M M M M M S S M M S S
S S S S M S S M 4 S M S M S M M S S S M S S S M S S M M S M M M S M M M M M M S
S M M M M S M M M M M S S M M M M S S M M M M M M S S M M M S S 2 M M 2 M M M S
S S S S S S S S S S S S S S S S S S S S S S S S S S S S S S S S S S S S S S S S
