40 25
- M M M M M M M M M M M M M M M M M M S S M M M M M M M M M M M M M M M M M M -
S S S S S S S S S S S S S S S S S S M S S M S S S S S S S S S S S S S S S S S S
S S S S S S S S S S S S S S S S S S E E E E S S S S S S S S S S S S S S S S S S
1 M M S M M M M S M M M S M M 1 S S M M M M S M M M M M M M M M M M M M M M M M
M S M M 1 S S 1 M M S M S M S M S S M M M M M M M S S S S S S S S S S S S S M M
M S S S S S S S S S S M S M S M S S S S S S S S S S M M M M M M M M M M M S M M
M M M M M M M M M M M M S M S M M S S S S M M M M M M M M M M M M M S S M S M S
M S S S S S S S S S S M S M S M M M M M S M M S M M S S M S S S S S S S M S M M
M S M M 10 M M M M 10 S M S M S M M S S S M M M S M M M S M M M 1 1 1 S M M S M M
M S M S S S S S S S S M S M S M M S S M M M S S M M M S S S S 1 1 1 S M M S S M
M S M M M S M 10 M M S M S M S M M S M M M S S S M M M M M M S 1 1 1 S M M S M M
M S M S S S S S S M S M S M S M M S M S S S 1 M M S S S S M S S S S S M M E M M
M S M M 10 M S M M M S M E M S M M E M S 5 S M S S S 1 M M M M M 1 S S S M E M S
M S M S S S S S S M S S S M S M M S M S S S 1 M M S S S S M S S S S S M M E M M
M S M M M S M 10 M M E M S M S M M S M M M S S S M M M M M M S 1 1 1 S M M S M M
M S M S S S S S S M S M S M S M M S S M M M S S M M M S S S S 1 1 1 S M M S S M
M S M M M M M M M M S M S M S M M S S S M M M S M M M S M M M 1 1 1 S M M S M M
M S S S S S S S S S S M S M S M M M M M S M M S M M S S M S S S S S S S M S M M
M M M M M M M M M M M M S M S M M S S S S M M M M M M M M M M M M M S S M S M S
M S S S S S S S S S S M S M S M S S S S S S S S S S M M M M M M M M M M M S M M
M S M M 1 S S 1 M M S M S M S M S S M M M M M M M S S S S S S S S S S S S S M M
1 M M S M M M M S M M M S M M 1 S S M M M M S M M M M M M M M M M M M M M M M M
S S S S S S S S S S S S S S S S S S E E E E S S S S S S S S S S S S S S S S S S
S S S S S S S S S S S S S S S S S S M S S M S S S S S S S S S S S S S S S S S S
- M M M M M M M M M M M M M M M M M M S S M M M M M M M M M M M M M M M M M M -
