45 25
- M M M M M M M M M M M M M M M M M M M M S S S M M M M M M M M M M M M M M M M M M M M -
S S S S S S S S S S S S S S S S S S S S M M M M M S S S S S S S S S S S S S S S S S S S S
M M M M S M M M M M M M M M M S M M M M S S E S S M M M M S M M M M M M M M M M S M M M M
M S M M M M S M M M M M M S M M M S S M S E M E S M S S M M M S M M M M M M S M M M M S M
M M S S S S S S S S S S S S S S S S S M S E E E S M S S S S S S S S S S S S S S S S S M M
S M S M M M M M M M M M M M M M M S S M S S E S S M S S M M M M M M M M M M M M M M S M S
M M S M S E S E S E S E S E S S M M S M M M M M M M S M M S S E S E S E S E S E S M S M M
M M S M E S M S M S M S M S S S S M S S S S S S S S S M S S S S M S M S M S M S E M S M M
M S S M E M M M M M M M M M M M S M M M M M M M M M M M S M M M M M M M M M M M E M S S M
M S S M S S S S S S S S S S M M S M S S S S S S S S S M S M M S S S S S S S S S S M S S M
M M S M E M M M M M M M M S S M S M S S E M E M E S S M S M S S M M M M M M M M E M S M M
S M S M S S S S S S S S S S M M S M S S M 25 M 25 M S S M S M M S S S S S S S S S S M S M S
S M E M E M M M M M M M M S S M S M E E E M S M E E E M S M S S M M M M M M M M E M E M S
S M S M S S S S S S S S S S M M S M S S M 25 M 25 M S S M S M M S S S S S S S S S S M S M S
M M S M E M M M M M M M M S S M S M S S E M E M E S S M S M S S M M M M M M M M E M S M M
M S S M S S S S S S S S S S M M S M S S S S S S S S S M S M M S S S S S S S S S S M S S M
M S S M E M M M M M M M M M M M S M M M M M M M M M M M S M M M M M M M M M M M E M S S M
M M S M E S M S M S M S M S S S S M S S S S S S S S S M S S S S M S M S M S M S E M S M M
M M S M S E S E S E S E S E S S M M S M M M M M M M S M M S S E S E S E S E S E S M S M M
S M S M M M M M M M M M M M M M M S S M S S E S S M S S M M M M M M M M M M M M M M S M S
M M S S S S S S S S S S S S S S S S S M S E E E S M S S S S S S S S S S S S S S S S S M M
M S M M M M S M M M M M M S M M M S S M S E M E S M S S M M M S M M M M M M S M M M M S M
M M M M S M M M M M M M M M M S M M M M S S E S S M M M M S M M M M M M M M M M S M M M M
S S S S S S S S S S S S S S S S S S S S M M M M M S S S S S S S S S S S S S S S S S S S S
- M M M M M M M M M M M M M M M M M M M M S S S M M M M M M M M M M M M M M M M M M M M -
